0000000111000000000000011100000000000001110000000000000111000000
1111000000000000111100000000000011110000000000001111000000000000
0000000001011110000000000101111000000000010111100000000001011110
0011100001010010001110000101001000111000010100100011100001010010
0010000001000110001000000100011000100000000001100010000001000110
0000000001000100000000000000010000000000000001000000000001000100
0000110001000000000011000100000000001100010000000000110001000000
0000000001011000000000000101100000000000010110000000000001011000
0000000000000000000000000000000000000000000000000000000000000000
0000000000000000000000000000000000000000000000000000000000000000
0000000000000000000000000000000000000000000000000000000000000000
0000000000000000000000000000000000000000000000000000000000000000
0000000000000000000000000000000000000000000000000000000000000000
0000000000000000000000000000000000000000000000000000000000000000
0000000000000000000000000000000000000000000000000000000000000000
0000000000000000000000000000000000000000000000000000000000000000
0000000000000000000000000000000000000000000000000000000000000000
0000000000000000000000000000000000000000000000000000000000000000
0000011000000000000001100000000000000110000000000000011000000000
0000000111000000000000011100000000000001110000000000000111000000
1111000000000000111100000000000011110000000000001111000000000000
0000000001011110000000000101111000000000010111100000000001011110
0011100001010010001110000101001000111000010100100011100001010010
0010000001000110001000000000011000100000000001100010000001000110
0000000001000100000000000100010000000000000001000000000001000100
0000110001000000000011000100000000001100010000000000110001000000
0000000001011000000000000101100000000000010110000000000001011000
0000011000000000000001100000000000000110000000000000011000000000
0000000001011000000000000101100000000000010110000000000001011000
0011100001010010001110000101001000111000010100100011100001010010
0000000111000000000000011100000000000001110000000000000111000000
0010000001000110001000000100011000100000010001100010000001000110