0000000111000000
111100000000
0000000001011110
0011100001010010
0010000001000110
0000000001000100
0000110001000
000000000101100
00000110000